1111111111111
1001000100001
1110000000011
1000000010001
1000000010001
1101P1C1000E1
1111111111111
