1111111111111
1001000100001
1110000000011
1000000010001
100P000010001
11010101C00E1
1111111111111